XXXXXXXXXXXXXXX
X             X
X             X
X             X
X             X
X             X
X             X
XXXXXXXXXXXXX X
X             X
X             X
X             X
X             X
X             X
X             X
XXXXXXXXXXXXXXX
