XXXXXXXXXXXXXXXXXXXXXXXXXXXXXXXXXXXXXXXXXXXXXXXXXXXXXXXXXXXXXXXXXXXXXXXXXXXXXX
X     XXXXXXX         XX                                XXXXXXXXXXXXXXXXXXXXXX
X                XXXXXXXXXXXX    XXXXXXXX                                XXXXX
XX                       XXXX     XXXXXXXXX       XXXXXXXXXXXXXXXXXXXXXXXXXXXX
XXXX    X         XXX                        XXXXXXXXXXXXXXXXXXXXXXXXXXXXX    
XXXX   X   X    X      X                                XXXXXXXXXXXXXXXXXX   X
XXXXX     X     X   X XXXXXXXXXXX                     XX           XXXX X   XX
XXXXXXX            X  XX    X           XXXXXXXXXXXXXXXXXXXXX     XXXXX X XXXX
XXXXXXX   XX  XX     XX       XXXXXXXXXXXXXXX                       XX  X XXXX
XXXXX     X                XXXXXXXXX                     XXXXXX    XXXX  XXXXX
XXXXXXXX  XXX          XXX     XXXXXXX      XXXXXXXXXXX     XXXX        XXXXXX
XXXXXXXXX                           XXX           XXXXXXXXX  XXXXXXXXXXXXXXXXX
XXXXXXXXXXXXXX   X    XXXXXXXXXXXXXXXXXXXX    XXX XXXXXXXXXXX     XXXXXXXXXXXX
XXXXXXXXXXXXXXXX   XXXXXXXXXXXXXXXXXXXXXX       XX             XXXXXXXXXXXXXXX
XXXXXXXXXXXXXXXXXXXXXXXXXXXXXXXXXXXXXXXXXXX         XXXXXXXXXXXXXXXXXXXXXXXXXX
