XXXXXXXXXXXXXXX
X             X
X             X
X             X
X             X
X             X
X             X
XXXXXXXXXXXX  X
X             X
X        XXXXXX
XXXXXX        X
X    XX       X
X     XX      X
X             X
XXXXXXXXXXXXXXX
